X;X;X;X;X;X;X;X;X;X;X;X;X;X;X
X;X;X;X;X;X;X;X;X;X;X;X;X;X;X
X;X;D;P;X;;;X;X;X;X;X;X;X;X
X;X;X;;X;;;X;X;X;X;X;X;X;X
X;X;X;;S;;;X;X;X;X;X;X;X;X
X;X;X;;P;;;P;;F;X;X;X;X;X
X;X;X;;S;;;X;X;X;X;X;X;X;X
X;X;X;;X;;;X;X;X;X;X;X;X;X
X;X;X;;X;;;X;X;X;X;X;X;X;X
X;X;X;X;X;X;X;X;X;X;X;X;X;X;X
X;X;X;X;X;X;X;X;X;X;X;X;X;X;X
X;X;X;X;X;X;X;X;X;X;X;X;X;X;X
X;X;X;X;X;X;X;X;X;X;X;X;X;X;X
X;X;X;X;X;X;X;X;X;X;X;X;X;X;X
X;X;X;X;X;X;X;X;X;X;X;X;X;X;X
