X;X;X;X;X;X;X;X;X;X;X;X;X;X;X
X;S;S;S;S;S;S;S;S;S;S;S;S;S;X
X;S;S;S;S;S;S;S;S;S;S;S;S;S;X
X;S;S;S;S;S;S;S;S;S;S;S;S;S;X
X;S;S;S;S;S;S;S;S;S;S;S;S;S;X
X;S;X;X;X;X;S;D;S;;P;;S;S;X
X;S;X;X;X;X;S;P;S;;S;;S;S;X
X;S;X;;;X;S;;S;;S;;S;S;X
X;S;X;;;X;S;;S;;S;;S;S;X
X;S;X;;;X;S;;S;;S;;S;S;X
X;S;X;X;X;X;S;;S;;S;;S;S;X
X;S;X;X;X;X;S;;S;;S;F;S;S;X
X;S;S;S;S;S;S;P;;;S;S;S;S;X
X;S;S;S;S;S;S;S;S;S;S;S;S;S;X
X;X;X;X;X;X;X;X;X;X;X;X;X;X;X
