X;X;X;X;X;X;X;X;X;X;X;X;X;X;X
X;X;X;D;X;X;;B;;;X;;;;X
X;X;X;B;X;X;;X;;;X;;;;X
X;;;;;X;;X;;;X;;X;;X
X;;X;;X;;;X;;;B;;;;X
X;;X;X;X;;;X;X;X;;;X;;X
X;B;B;;;;;B;;X;;;X;;X
X;;X;;;X;X;;;X;X;X;;;X
X;X;;;;;;;;X;X;X;;;X
X;;;;;;;;;X;X;X;;;X
X;;;S;S;;;;;X;X;X;;;X
X;;;S;S;;;;;X;X;X;;;X
X;;;;;S;;;;X;X;X;;;X
X;;;;;;S;;;X;X;X;;F;X
X;X;X;X;X;X;X;X;X;X;X;X;X;X;X
